XXXXXXXXXXXXXXXXXXXXXXXXXXXXXXXXXXXXXXXXXXXXXXXXXXXXXXXXXXXXXXX
X                                                             X
X                                                             X
X                                                             X
X                                                             X
X                                                             X
X                                                             X
X                                                             X
X                                                             X
X                                                             X
X                                                             X
X                                                             X
X                                                             X
X                          XXXXXXXXX                          X
X                          XXXXXXXXX                          X
X                          XXXXXXXXX                          X
X                          XXXXXXXXX                          X
X                          XXXXXXXXX                          X
X                                                             X
X                                                             X
X                                                             X
X                                                             X
X                                                             X
X                                                             X
X                                                             X
X                                                             X
X                                                             X
X                                                             X
X                                                             X
X                                                             X
X                                                             X
XXXXXXXXXXXXXXXXXXXXXXXXXXXXXXXXXXXXXXXXXXXXXXXXXXXXXXXXXXXXXXX
